selam : hello
naber : what's up
güzel : beautiful
iyi : good
sari : yellow
yesil : green
agaç : tree
cicek : flower
insan : human
kaplan : tiger
ayi : bear
aslan : lion
kalem : pen
kedi : cat
gunes : sun
pencere : window
ay : moon
tabak : plate
catal : fork
siyah : black
beyaz : white
mor : purple
silgi : eraser
okul : school
yönetici : manager
ogrenci : student
umit : hope
ayak : foot
parmak : finger
okul : school
su : water